NO ./textures/N
SO ./textures/S
WE ./textures/W
EA ./textures/E
F 0,10,10
C 50,0,10

     1               1
    101             101
     101           101
      101         101
       101       101
        101     101
         101   101
          1011101
           10N01
          1011101
         101   101
        101     101
       101       101
      101         101
     101           101
    101             101
   101               101
  101                 101
 101                   101
  1                     1