      NO          ./textures/N
SO ./textures/S

WE ./textures/W

EA ./textures/E
F 0,    200,       10
C 50,0,150

      11               11
     1001             1001
      1001           1001
       1001         1001
        1001       1001
         1001     1001
          1001   1001
           1001 1001
            10011001
            1000N001
            10011001
           1001  1001
          1001    1001
         1001      1001
        1001        1001
       1001          1001
      1001            1001
     1001              1001
    1001                1001
   1001                  1001
  1001                    1001
 1001                      1001
1001                        1001
 11                          11