NO ./textures/N
SO ./textures/S
WE ./textures/W
EA ./textures/E
F 0,10,10
C 50,0,10


1111111111111           1111111111111        1111111111111
1000000000001           1000000000001        1000000000001
1000000000001           1000000000001        1000000000001
1000000000001           1000000000001        1000000000001
1000000000001           1000000000001        1000000000001
1000000000001           1000000000001        1000000000001
1000000000001           1000000000001        1000000000001
1000000000001           1000000000001        1000000000001
1000000000001111111111111000000000001        1000000000001
1000000000000000000000000000000000001111111111000000000001
1000000000000000000000000000000000000000W00000000000000001
1000000000000000000000000000000000001111111111000000000001
1000000000001111111111111000000000001        100000000000111111111111
1000000000001           1000000000001        100000000000000000000001
1000000000001           1000000000001        100000000000000000000001
1000000000001           1000000000001        100000000000000000000001
1000000000001           1000000000001        100000000000000000000001
1000000000001           1000000000001        100000000000000000000001
1000000000001           1000000000001        100000000000000000000001
1000000000001           1000000000001        100000000000000000000001
1111111111111           1111111111111        111111111111111111111111