NO ./textures/N

SO ./textures/S

WE ./textures/W

EA ./textures/E

F 0,10,10
C 50,0,10

11111111111111111111111111111111
1S000001111100011100000000000001
10111011110001110001111110111101
10100010000000000001111110111101
10101110011111110001111110011101
10101110011111111111111110111111
10101110011111111101111100111011
10100000011111100001111001111011
10111011111111101111111011111011
10000000110000000000000011110011
11101111110111111100111000000111
11101110000111111111111111111111
11101110111100000000000000000001
11101110111101111111111111011101
11101110011101100001111100011101
11101111D11101101100001110111101
11101111111101001111111111111101
11100000000001000000000000000001
11111111111111111111111111111111