NO ./textures/N

SO ./textures/S

WE ./textures/W

EA ./textures/E

F 0,10,10
C 50,0,10

11111111111111111111111111111111
1S000001111100011100000000000001
10111011110001110001111111111101
10100010000000000001111111111101
10101110011111110001111111111101
10101110011111111111111111111111
10101110011111111111111111111111
10100000011111111111111111111111
10111011111111111111111111111111
10000000111111111111111111111111
11101111111111111111111111111111
11101111111111111111111111111111
11101111111100000000000000000001
11101111111101111111111111111111
11101111111101111111111111111111
11101111111101111111111111111111
11101111111101111111111111111111
11100000000001111111111111111111
11111111111111111111111111111111