
NO ./textures/N

SO ./textures/S

WE ./textures/W

EA ./textures/E

F 250,100, 124
C 230,100,60

11111111111111111111111111111111
11100001111100000000000000000001
10111011110001110001111111111101
10100010000001110001111111111101
10101110011111110001111111111101
10101110011111111111111111111111
10101110011111111111111111111111
10100010011111111111111111111111
10111010111111111111111111111111
10000000111111111111111111111111
11101111111111111111111111111111
11101111111111111111111111111111
11101111111100000000000000000001
11101111111101111111111110111101
11101111111101111111111111111101
11101111111101111111111111111101
111011111111011111111111111111W1
111000000000011111111111111111N1
11111111111111111111111111111111
1
1
1
1
