

NO               ./textures/N

SO                 ./textures/S

        
WE      ./textures/W
            
EA     ./textures/E

F 0,10,10     
C 50,0,10


1111111
10000S1
1011111
1000011
1010001
1111111