

              NO               ./textures/no.xpm
         C 50,0,10
F 0,10,10
        		EA     ./textures/ea.xpm

          SO                 ./textures/so.xpm

            WE      ./textures/we.xpm

1111111
1000001
1011111
1000011
1S10001
1111111
     
111
11
    