

NO               ./textures/N

SO                 ./textures/S

        
WE      ./textures/W
            
EA     ./textures/E

F 255,255,255
C 50,250,0


111111111 1   1
1111W1110101 101
111111111 1   1
 