

NO               ./textures/N

SO                 ./textures/S

        
WE      ./textures/W
            
EA     ./textures/E

F 0,10,10     
C 50,250,0


111111111 1 
1111W1110101
111111111 1