

NO               ./textures/N

SO                 ./textures/S

        
WE      ./textures/W
            
EA     ./textures/E

F 255,255,255
C 50,250,0

	

1111111111   1
11111110101 1N1
1000000011   1
111111111 1   1    




          