
NO src/north.xpm


SO src/south.xpm
WE src/west.xpm
EA src/east.xpm
F 200,200,255
C 190,30,251

111111111x
1000000001
1000N1111x
100001xxxx
111111xxxx
1xxxxxxxxx
1111xxxxxx
