
NO src/north.xpm

SO src/south.xpm
F 225,50,255

WE src/west.xpm


EA src/east.xpm
C 255,30,200

111111
100001
1000N1
100001
111111
1
1111
