NO src/north.xpm
SO src/south.xpm
WE src/west.xpm
EA src/east.xpm
F 225,50,255
C 1,30,200

111111
100001
1000N1
100001
111111
1
1111
