

NO src/north.xpm

SO src/south.xpm
WE src/west.xpm
EA src/east.xpm
F 120,200,255
C 190,30,251

111111111
1000000001
1000N1111
100001
111111
1
1111
